111111111111
120000000001
101111111101
100000000101
111011111101
100010000001
101110111101
100000100003
111111111111