1111111111
1200000001
1011111101
1000000101
1110110101
1000100101
1011100101
1000000003
1111111111